11111111111111
1C00E000000001
1P000000000001
11000000100001
10000001110001
1CC00000C00001
11111111111111
